WWWWWWWWWWWWWWWWWWWWWWWWWWWWWWWWWWWWWW
WGGGWGGGW1122112211221122112211221122W
WGGGWGGGW1122112211221122112211221122W
WGGGWGGGW1122112211221122112211221122W
W                                    W
W                            S   S   W
W                                    W
W                            S   S   W
W                                    W
WGGGWGGGW1122112211221122112211221122W
WGGGWGGGW1122112211221122112211221122W
WGGGWGGGW1122112211221122112211221122W
WWWWWWWWWWWWWWWWWWWWWWWWWWWWWWWWWWWWWW