WWWWWWWWWW
WGGWGGW12W
WGGWGGW12W
WGGWGGW12W
W        W
W     S  W
W        W
W     S  W
W        W
WGGWGGW12W
WGGWGGW12W
WGGWGGW12W
WWWWWWWWWW